id;id_patient;report_date;app_time;recipe_time;diary_time;music_genre;creation_date
1;test_patient1;2019-01-12;100;90;10;jazz;2019-04-11
2;test_patient1;2019-02-12;200;80;120;classic;2019-04-11
3;test_patient1;2019-03-12;100;90;10;rock;2019-04-11
8;test_patient1;2019-04-12;41;1;40;classic;2019-04-16
9;test_patient1;2019-05-12;3688;461;3227;rock;2019-04-17
14;test_patient1;2019-06-12;3208;267;2941;classic;2019-04-22
15;test_patient1;2019-07-12;1226;15;1211;rock;2019-04-23
19;test_patient1;2019-08-12;1664;83;1581;jazz;2019-04-27
28;test_patient10;2019-01-12;2497;35;2462;jazz;2019-05-06
118;test_patient100;2019-02-12;218;4;214;jazz;2019-08-04
119;test_patient101;2019-03-12;3294;52;3242;classic;2019-08-05
120;test_patient102;2019-04-12;2340;49;2291;rock;2019-08-06
121;test_patient103;2019-05-12;2552;102;2450;jazz;2019-08-07
122;test_patient104;2019-06-12;4613;76;4537;classic;2019-08-08
123;test_patient105;2019-07-12;3224;90;3134;rock;2019-08-09
124;test_patient106;2019-08-12;1094;61;1033;jazz;2019-08-10
125;test_patient107;2019-01-12;1792;43;1749;classic;2019-08-11
126;test_patient108;2019-02-12;2291;2291;0;rock;2019-08-12
127;test_patient109;2019-03-12;3303;40;3263;jazz;2019-08-13
29;test_patient11;2019-04-12;1158;25;1133;classic;2019-05-07
128;test_patient110;2019-05-12;3725;42;3683;classic;2019-08-14
129;test_patient111;2019-06-12;3975;189;3786;rock;2019-08-15
130;test_patient112;2019-07-12;3030;56;2974;jazz;2019-08-16
131;test_patient113;2019-08-12;3255;148;3107;classic;2019-08-17
132;test_patient114;2019-01-12;320;6;314;rock;2019-08-18
133;test_patient115;2019-02-12;4565;63;4502;jazz;2019-08-19
134;test_patient116;2019-03-12;3834;426;3408;classic;2019-08-20
135;test_patient117;2019-04-12;2627;48;2579;rock;2019-08-21
136;test_patient118;2019-05-12;2847;30;2817;jazz;2019-08-22
137;test_patient119;2019-06-12;3108;43;3065;classic;2019-08-23
30;test_patient12;2019-07-12;2074;23;2051;rock;2019-05-08
138;test_patient120;2019-08-12;3492;62;3430;rock;2019-08-24
139;test_patient121;2019-01-12;3543;111;3432;jazz;2019-08-25
140;test_patient122;2019-02-12;1765;37;1728;classic;2019-08-26
141;test_patient123;2019-03-12;4462;172;4290;rock;2019-08-27
142;test_patient124;2019-04-12;1877;23;1854;jazz;2019-08-28
143;test_patient125;2019-05-12;1285;26;1259;classic;2019-08-29
144;test_patient126;2019-06-12;2077;21;2056;rock;2019-08-30
145;test_patient127;2019-07-12;3169;198;2971;jazz;2019-08-31
146;test_patient128;2019-08-12;3527;118;3409;classic;2019-09-01
147;test_patient129;2019-01-12;2248;112;2136;rock;2019-09-02
31;test_patient13;2019-02-12;134;2;132;jazz;2019-05-09
148;test_patient130;2019-03-12;3147;33;3114;jazz;2019-09-03
149;test_patient131;2019-04-12;748;39;709;classic;2019-09-04
150;test_patient132;2019-05-12;2427;46;2381;rock;2019-09-05
151;test_patient133;2019-06-12;3444;44;3400;jazz;2019-09-06
152;test_patient134;2019-07-12;2874;35;2839;classic;2019-09-07
153;test_patient135;2019-08-12;402;18;384;rock;2019-09-08
154;test_patient136;2019-01-12;1070;41;1029;jazz;2019-09-09
155;test_patient137;2019-02-12;3962;64;3898;classic;2019-09-10
156;test_patient138;2019-03-12;3209;32;3177;rock;2019-09-11
157;test_patient139;2019-04-12;2157;39;2118;jazz;2019-09-12
32;test_patient14;2019-05-12;2588;60;2528;classic;2019-05-10
158;test_patient140;2019-06-12;1171;15;1156;classic;2019-09-13
159;test_patient141;2019-07-12;144;2;142;rock;2019-09-14
160;test_patient142;2019-08-12;4227;106;4121;jazz;2019-09-15
161;test_patient143;2019-01-12;275;5;270;classic;2019-09-16
162;test_patient144;2019-02-12;4561;79;4482;rock;2019-09-17
163;test_patient145;2019-03-12;2350;32;2318;jazz;2019-09-18
164;test_patient146;2019-04-12;37;1;36;classic;2019-09-19
165;test_patient147;2019-05-12;4900;98;4802;rock;2019-09-20
166;test_patient148;2019-06-12;2142;31;2111;jazz;2019-09-21
167;test_patient149;2019-07-12;856;15;841;classic;2019-09-22
33;test_patient15;2019-08-12;1085;21;1064;rock;2019-05-11
168;test_patient150;2019-01-12;3898;78;3820;rock;2019-09-23
169;test_patient151;2019-02-12;2844;61;2783;jazz;2019-09-24
170;test_patient152;2019-03-12;595;6;589;classic;2019-09-25
171;test_patient153;2019-04-12;652;7;645;rock;2019-09-26
172;test_patient154;2019-05-12;2186;33;2153;jazz;2019-09-27
173;test_patient155;2019-06-12;4868;79;4789;classic;2019-09-28
174;test_patient156;2019-07-12;3356;80;3276;rock;2019-09-29
175;test_patient157;2019-08-12;2597;260;2337;jazz;2019-09-30
176;test_patient158;2019-01-12;1731;75;1656;classic;2019-10-01
177;test_patient159;2019-02-12;1271;24;1247;rock;2019-10-02
34;test_patient16;2019-03-12;949;119;830;jazz;2019-05-12
178;test_patient160;2019-04-12;603;7;596;jazz;2019-10-03
179;test_patient161;2019-05-12;2411;42;2369;classic;2019-10-04
180;test_patient162;2019-06-12;20;0;20;rock;2019-10-05
181;test_patient163;2019-07-12;2329;44;2285;jazz;2019-10-06
182;test_patient164;2019-08-12;2087;41;2046;classic;2019-10-07
183;test_patient165;2019-01-12;621;8;613;rock;2019-10-08
184;test_patient166;2019-02-12;4438;178;4260;jazz;2019-10-09
185;test_patient167;2019-03-12;1887;944;943;classic;2019-10-10
186;test_patient168;2019-04-12;3448;41;3407;rock;2019-10-11
187;test_patient169;2019-05-12;3388;46;3342;jazz;2019-10-12
35;test_patient17;2019-06-12;2324;49;2275;classic;2019-05-13
188;test_patient170;2019-07-12;4999;68;4931;classic;2019-10-13
189;test_patient171;2019-08-12;4078;52;4026;rock;2019-10-14
190;test_patient172;2019-01-12;2468;39;2429;jazz;2019-10-15
191;test_patient173;2019-02-12;1646;20;1626;classic;2019-10-16
192;test_patient174;2019-03-12;312;3;309;rock;2019-10-17
193;test_patient175;2019-04-12;2094;116;1978;jazz;2019-10-18
194;test_patient176;2019-05-12;1453;19;1434;classic;2019-10-19
195;test_patient177;2019-06-12;1554;16;1538;rock;2019-10-20
196;test_patient178;2019-07-12;2628;30;2598;jazz;2019-10-21
197;test_patient179;2019-08-12;572;13;559;classic;2019-10-22
36;test_patient18;2019-01-12;2453;25;2428;rock;2019-05-14
198;test_patient180;2019-02-12;2560;142;2418;rock;2019-10-23
199;test_patient181;2019-03-12;2114;57;2057;jazz;2019-10-24
200;test_patient182;2019-04-12;656;12;644;classic;2019-10-25
201;test_patient183;2019-05-12;1954;21;1933;rock;2019-10-26
202;test_patient184;2019-06-12;4270;97;4173;jazz;2019-10-27
203;test_patient185;2019-07-12;3180;42;3138;classic;2019-10-28
204;test_patient186;2019-08-12;2854;1427;1427;rock;2019-10-29
205;test_patient187;2019-01-12;4626;57;4569;jazz;2019-10-30
268;test_patient187;2019-02-12;4702;71;4631;jazz;2020-01-01
276;test_patient187;2019-03-12;4149;65;4084;rock;2020-01-09
284;test_patient187;2019-04-12;2409;78;2331;classic;2020-01-17
292;test_patient187;2019-05-12;1691;28;1663;jazz;2020-01-25
206;test_patient188;2019-06-12;94;1;93;classic;2019-10-31
269;test_patient188;2019-07-12;4197;120;4077;classic;2020-01-02
277;test_patient188;2019-08-12;3101;34;3067;jazz;2020-01-10
285;test_patient188;2019-09-12;171;3;168;rock;2020-01-18
293;test_patient188;2019-10-12;4342;63;4279;classic;2020-01-26
207;test_patient189;2019-01-12;2631;219;2412;rock;2019-11-01
270;test_patient189;2019-02-12;4644;73;4571;rock;2020-01-03
278;test_patient189;2019-03-12;3291;72;3219;classic;2020-01-11
286;test_patient189;2019-04-12;4848;1212;3636;jazz;2020-01-19
294;test_patient189;2019-05-12;463;7;456;rock;2020-01-27
37;test_patient19;2019-06-12;4270;44;4226;jazz;2019-05-15
208;test_patient190;2019-07-12;2096;349;1747;jazz;2019-11-02
271;test_patient190;2019-08-12;4217;69;4148;jazz;2020-01-04
279;test_patient190;2019-09-12;4208;96;4112;rock;2020-01-12
287;test_patient190;2019-10-12;1179;15;1164;classic;2020-01-20
295;test_patient190;2019-01-12;1302;47;1255;jazz;2020-01-28
209;test_patient191;2019-02-12;2175;75;2100;classic;2019-11-03
272;test_patient191;2019-03-12;2967;212;2755;classic;2020-01-05
280;test_patient191;2019-04-12;2803;54;2749;jazz;2020-01-13
288;test_patient191;2019-05-12;2551;102;2449;rock;2020-01-21
296;test_patient191;2019-06-12;3285;37;3248;classic;2020-01-29
210;test_patient192;2019-07-12;179;2;177;rock;2019-11-04
273;test_patient192;2019-08-12;1647;40;1607;rock;2020-01-06
281;test_patient192;2019-09-12;1355;18;1337;classic;2020-01-14
289;test_patient192;2019-10-12;3303;34;3269;jazz;2020-01-22
297;test_patient192;2019-01-12;4063;74;3989;rock;2020-01-30
211;test_patient193;2019-02-12;465;13;452;jazz;2019-11-05
274;test_patient193;2019-03-12;3418;35;3383;jazz;2020-01-07
282;test_patient193;2019-04-12;1502;15;1487;rock;2020-01-15
290;test_patient193;2019-05-12;1890;19;1871;classic;2020-01-23
298;test_patient193;2019-06-12;4627;193;4434;jazz;2020-01-31
212;test_patient194;2019-07-12;1154;26;1128;classic;2019-11-06
275;test_patient194;2019-08-12;3227;85;3142;classic;2020-01-08
283;test_patient194;2019-09-12;2572;26;2546;jazz;2020-01-16
291;test_patient194;2019-10-12;3121;223;2898;rock;2020-01-24
299;test_patient194;2019-01-12;4878;157;4721;classic;2020-02-01
300;test_patient194;2019-02-12;324;15;309;rock;2020-02-02
213;test_patient195;2019-03-12;3559;58;3501;rock;2019-11-07
214;test_patient196;2019-04-12;3069;77;2992;jazz;2019-11-08
215;test_patient197;2019-05-12;4053;253;3800;classic;2019-11-09
216;test_patient198;2019-06-12;4216;128;4088;rock;2019-11-10
217;test_patient199;2019-07-12;2016;252;1764;jazz;2019-11-11
4;test_patient2;2019-08-12;3763;111;3652;jazz;2019-04-12
5;test_patient2;2019-09-12;4037;41;3996;classic;2019-04-13
10;test_patient2;2019-10-12;621;27;594;jazz;2019-04-18
11;test_patient2;2019-05-12;1552;16;1536;classic;2019-04-19
16;test_patient2;2019-01-12;4057;97;3960;jazz;2019-04-24
17;test_patient2;2019-02-12;459;10;449;classic;2019-04-25
20;test_patient2;2019-03-12;1656;52;1604;classic;2019-04-28
38;test_patient20;2019-04-12;2137;43;2094;classic;2019-05-16
218;test_patient200;2019-05-12;4156;198;3958;classic;2019-11-12
219;test_patient201;2019-06-12;2679;44;2635;rock;2019-11-13
220;test_patient202;2019-07-12;2498;29;2469;jazz;2019-11-14
232;test_patient202;2019-08-12;1731;157;1574;jazz;2019-11-26
244;test_patient202;2019-09-12;3774;56;3718;jazz;2019-12-08
256;test_patient202;2019-10-12;1563;82;1481;jazz;2019-12-20
221;test_patient203;2019-01-12;1941;23;1918;classic;2019-11-15
233;test_patient203;2019-02-12;1505;29;1476;classic;2019-11-27
245;test_patient203;2019-03-12;4950;146;4804;classic;2019-12-09
257;test_patient203;2019-04-12;3709;45;3664;classic;2019-12-21
222;test_patient204;2019-05-12;1876;117;1759;rock;2019-11-16
234;test_patient204;2019-06-12;4281;357;3924;rock;2019-11-28
246;test_patient204;2019-07-12;2285;42;2243;rock;2019-12-10
258;test_patient204;2019-08-12;2059;44;2015;rock;2019-12-22
223;test_patient205;2019-09-12;4615;115;4500;jazz;2019-11-17
235;test_patient205;2019-10-12;4995;89;4906;jazz;2019-11-29
247;test_patient205;2019-01-12;3856;57;3799;jazz;2019-12-11
259;test_patient205;2019-02-12;1;0;1;jazz;2019-12-23
224;test_patient206;2019-03-12;4476;4476;0;classic;2019-11-18
236;test_patient206;2019-04-12;2695;32;2663;classic;2019-11-30
248;test_patient206;2019-05-12;2071;36;2035;classic;2019-12-12
260;test_patient206;2019-06-12;3956;49;3907;classic;2019-12-24
225;test_patient207;2019-07-12;3993;77;3916;rock;2019-11-19
237;test_patient207;2019-08-12;1319;43;1276;rock;2019-12-01
249;test_patient207;2019-09-12;4625;66;4559;rock;2019-12-13
261;test_patient207;2019-01-12;4880;83;4797;rock;2019-12-25
226;test_patient208;2019-02-12;4764;340;4424;jazz;2019-11-20
238;test_patient208;2019-03-12;4720;157;4563;jazz;2019-12-02
250;test_patient208;2019-04-12;1272;23;1249;jazz;2019-12-14
262;test_patient208;2019-05-12;633;7;626;jazz;2019-12-26
227;test_patient209;2019-06-12;3219;104;3115;classic;2019-11-21
239;test_patient209;2019-07-12;941;14;927;classic;2019-12-03
251;test_patient209;2019-08-12;4054;48;4006;classic;2019-12-15
263;test_patient209;2019-09-12;1237;17;1220;classic;2019-12-27
39;test_patient21;2019-01-12;2386;42;2344;rock;2019-05-17
228;test_patient210;2019-02-12;1434;62;1372;rock;2019-11-22
240;test_patient210;2019-03-12;1794;21;1773;rock;2019-12-04
252;test_patient210;2019-04-12;2458;50;2408;rock;2019-12-16
264;test_patient210;2019-05-12;326;10;316;rock;2019-12-28
229;test_patient211;2019-06-12;1899;56;1843;jazz;2019-11-23
241;test_patient211;2019-07-12;3491;249;3242;jazz;2019-12-05
253;test_patient211;2019-08-12;4978;89;4889;jazz;2019-12-17
265;test_patient211;2019-09-12;3189;35;3154;jazz;2019-12-29
230;test_patient212;2019-10-12;1228;16;1212;classic;2019-11-24
242;test_patient212;2019-01-12;2985;38;2947;classic;2019-12-06
254;test_patient212;2019-02-12;225;3;222;classic;2019-12-18
266;test_patient212;2019-03-12;2906;40;2866;classic;2019-12-30
231;test_patient213;2019-04-12;4284;268;4016;rock;2019-11-25
243;test_patient213;2019-05-12;519;7;512;rock;2019-12-07
255;test_patient213;2019-06-12;4198;247;3951;rock;2019-12-19
267;test_patient213;2019-07-12;3756;376;3380;rock;2019-12-31
40;test_patient22;2019-08-12;4832;4832;0;jazz;2019-05-18
41;test_patient23;2019-09-12;975;13;962;classic;2019-05-19
42;test_patient24;2019-10-12;2019;48;1971;rock;2019-05-20
43;test_patient25;2019-01-12;816;10;806;jazz;2019-05-21
44;test_patient26;2019-02-12;4127;49;4078;classic;2019-05-22
45;test_patient27;2019-03-12;4878;1626;3252;rock;2019-05-23
46;test_patient28;2019-04-12;4034;86;3948;jazz;2019-05-24
47;test_patient29;2019-05-12;3606;44;3562;classic;2019-05-25
6;test_patient3;2019-06-12;2848;42;2806;rock;2019-04-14
7;test_patient3;2019-07-12;3678;127;3551;jazz;2019-04-15
12;test_patient3;2019-08-12;2689;269;2420;rock;2019-04-20
13;test_patient3;2019-09-12;4809;134;4675;jazz;2019-04-21
18;test_patient3;2019-01-12;2249;90;2159;rock;2019-04-26
21;test_patient3;2019-02-12;1545;16;1529;rock;2019-04-29
48;test_patient30;2019-03-12;3964;283;3681;rock;2019-05-26
49;test_patient31;2019-04-12;4782;81;4701;jazz;2019-05-27
50;test_patient32;2019-05-12;1919;55;1864;classic;2019-05-28
51;test_patient33;2019-06-12;2403;267;2136;rock;2019-05-29
52;test_patient34;2019-07-12;4608;1536;3072;jazz;2019-05-30
53;test_patient35;2019-08-12;3397;50;3347;classic;2019-05-31
54;test_patient36;2019-09-12;2860;43;2817;rock;2019-06-01
55;test_patient37;2019-01-12;2541;27;2514;jazz;2019-06-02
56;test_patient38;2019-02-12;2156;60;2096;classic;2019-06-03
57;test_patient39;2019-03-12;1824;36;1788;rock;2019-06-04
22;test_patient4;2019-04-12;120;5;115;jazz;2019-04-30
58;test_patient40;2019-05-12;4691;66;4625;jazz;2019-06-05
59;test_patient41;2019-06-12;1988;26;1962;classic;2019-06-06
60;test_patient42;2019-07-12;361;23;338;rock;2019-06-07
61;test_patient43;2019-08-12;2146;1073;1073;jazz;2019-06-08
62;test_patient44;2019-09-12;2281;253;2028;classic;2019-06-09
63;test_patient45;2019-10-12;2349;65;2284;rock;2019-06-10
64;test_patient46;2019-01-12;1229;205;1024;jazz;2019-06-11
65;test_patient47;2019-02-12;1050;13;1037;classic;2019-06-12
66;test_patient48;2019-03-12;2876;34;2842;rock;2019-06-13
67;test_patient49;2019-04-12;623;25;598;jazz;2019-06-14
23;test_patient5;2019-05-12;831;20;811;classic;2019-05-01
68;test_patient50;2019-06-12;4484;118;4366;classic;2019-06-15
69;test_patient51;2019-07-12;4522;98;4424;rock;2019-06-16
70;test_patient52;2019-08-12;4743;431;4312;jazz;2019-06-17
71;test_patient53;2019-09-12;2744;27;2717;classic;2019-06-18
72;test_patient54;2019-10-12;4056;145;3911;rock;2019-06-19
73;test_patient55;2019-01-12;1788;112;1676;jazz;2019-06-20
74;test_patient56;2019-02-12;4726;61;4665;classic;2019-06-21
75;test_patient57;2019-03-12;4335;73;4262;rock;2019-06-22
76;test_patient58;2019-04-12;1314;101;1213;jazz;2019-06-23
77;test_patient59;2019-05-12;904;13;891;classic;2019-06-24
24;test_patient6;2019-06-12;3098;107;2991;rock;2019-05-02
78;test_patient60;2019-07-12;3622;40;3582;rock;2019-06-25
79;test_patient61;2019-08-12;4926;77;4849;jazz;2019-06-26
80;test_patient62;2019-09-12;2442;407;2035;classic;2019-06-27
81;test_patient63;2019-10-12;1636;43;1593;rock;2019-06-28
82;test_patient64;2019-01-12;1825;47;1778;jazz;2019-06-29
83;test_patient65;2019-02-12;1368;14;1354;classic;2019-06-30
84;test_patient66;2019-03-12;798;8;790;rock;2019-07-01
85;test_patient67;2019-04-12;2819;37;2782;jazz;2019-07-02
86;test_patient68;2019-05-12;3778;52;3726;classic;2019-07-03
87;test_patient69;2019-06-12;1806;20;1786;rock;2019-07-04
25;test_patient7;2019-07-12;4294;77;4217;jazz;2019-05-03
88;test_patient70;2019-08-12;3132;48;3084;jazz;2019-07-05
89;test_patient71;2019-09-12;3737;1246;2491;classic;2019-07-06
90;test_patient72;2019-10-12;4392;133;4259;rock;2019-07-07
91;test_patient73;2019-01-12;4805;123;4682;jazz;2019-07-08
92;test_patient74;2019-02-12;4083;255;3828;classic;2019-07-09
93;test_patient75;2019-03-12;1983;51;1932;rock;2019-07-10
94;test_patient76;2019-04-12;4921;86;4835;jazz;2019-07-11
95;test_patient77;2019-05-12;4437;46;4391;classic;2019-07-12
96;test_patient78;2019-06-12;3019;82;2937;rock;2019-07-13
97;test_patient79;2019-07-12;4127;69;4058;jazz;2019-07-14
26;test_patient8;2019-08-12;1059;48;1011;classic;2019-05-04
98;test_patient80;2019-09-12;2287;33;2254;classic;2019-07-15
99;test_patient81;2019-10-12;4437;58;4379;rock;2019-07-16
100;test_patient82;2019-01-12;4836;63;4773;jazz;2019-07-17
101;test_patient83;2019-02-12;2793;36;2757;classic;2019-07-18
102;test_patient84;2019-03-12;326;4;322;rock;2019-07-19
103;test_patient85;2019-04-12;2742;83;2659;jazz;2019-07-20
104;test_patient86;2019-05-12;3116;65;3051;classic;2019-07-21
105;test_patient87;2019-06-12;3783;111;3672;rock;2019-07-22
106;test_patient88;2019-07-12;2096;34;2062;jazz;2019-07-23
107;test_patient89;2019-08-12;2142;29;2113;classic;2019-07-24
27;test_patient9;2019-09-12;3101;182;2919;rock;2019-05-05
108;test_patient90;2019-10-12;3561;40;3521;rock;2019-07-25
109;test_patient91;2019-01-12;4953;330;4623;jazz;2019-07-26
110;test_patient92;2019-02-12;1928;23;1905;classic;2019-07-27
111;test_patient93;2019-03-12;328;8;320;rock;2019-07-28
112;test_patient94;2019-04-12;1728;22;1706;jazz;2019-07-29
113;test_patient95;2019-05-12;4983;453;4530;classic;2019-07-30
114;test_patient96;2019-06-12;4848;56;4792;rock;2019-07-31
115;test_patient97;2019-07-12;300;9;291;jazz;2019-08-01
116;test_patient98;2019-08-12;3099;74;3025;classic;2019-08-02
117;test_patient99;2019-09-12;4000;59;3941;rock;2019-08-03
